NO                                                                     ./tiles/fonts/font0.png
F 158,158,158
SO       ./tiles/animation/DOUBLE BARREL/1.png
WE        ./tiles/animation/item/ammo.png


C 0,239,1

EA        ./tiles/animation/E11/4.png
1111  111111111111111111111111
10001   100000000011000000000111
11111   1011000001110000      001
        101000000000000000000001
111111111011000001110000000000001
100000000011000001110111111111111
11110111111111011100000010001
11110111111111011101010010001
11000000110110011100000000001
10000000000000001100000010001
10000000000000000001010011101
110000011101010111010110000011
11110111 1110101 10111101N001
11111111 1111111 111111111111
