NO ./tiles/textures/stone.png

SO ./tiles/textures/stone_eagle.png

WE ./tiles/textures/brique.png

EA ./tiles/textures/bricks.png

F 158,158,158

C 192,223,239

        1111111111111111111111
        100000000011000000000111
        1011000001110000      001
        101000000000000000000001
111111111011000001110000000000001
10000000001100000111D111111111111
11110111111111011100000010001
11110111111111011101D10010001
11000000110110011100000000001
10000000000000001100000010001
10000000000000000001D10011101
110000011101010111010110D00011
11110111 1110101 1011110100N1
11111111 1111111 111111111111
111111111111111111111111111111111
111111111111111111111111111111111
111111111111111111111111111111111
111111111111111111111111111111111
111111111111111111111111111111111
111111111111111111111111111111111
111111111111111111111111111111111
111111111111111111111111111111111
111111111111111111111111111111111
111111111111111111111111111111111
111111111111111111111111111111111
