NO ./tiles/stone.png

SO ./tiles/stone_eagle.png

WE ./tiles/brique.png

EA ./tiles/stone_bleu.png

F 255,100,0

C 225,30,0

        111111111111111111111
        111000000011000000000111
        1011000001110000      001
        111000000000000000000001
111111111111000001110000000000001
10000000001100000F110111111111111
11110111111111011100000010001
11110111111111011101010010001
11000000110101011100000000001
1000000000W000001100000010001
10000000000000001101010011001
110000011101010111010110100011
11110111 1110101 10111101W001
11111111 1111111 111111111111
